"filename", "language", "TypeScript", "comment", "blank", "total"
"c:\Users\Emir TARTAR\Desktop\SmartMolesProject\smart-moles-unit-of-work\src\app.module.ts", "TypeScript", 8, -1, -2, 5
"c:\Users\Emir TARTAR\Desktop\SmartMolesProject\smart-moles-unit-of-work\src\migrations\1659610287302-migrations.ts", "TypeScript", -14, 0, -5, -19
"c:\Users\Emir TARTAR\Desktop\SmartMolesProject\smart-moles-unit-of-work\src\units\users\contract\contractType\contractType.controller.ts", "TypeScript", 43, 0, 6, 49
"c:\Users\Emir TARTAR\Desktop\SmartMolesProject\smart-moles-unit-of-work\src\units\users\contract\contractType\contractType.dto.ts", "TypeScript", -3, 0, 0, -3
"c:\Users\Emir TARTAR\Desktop\SmartMolesProject\smart-moles-unit-of-work\src\units\users\contract\contractType\contractType.module.ts", "TypeScript", 12, 0, 3, 15
"c:\Users\Emir TARTAR\Desktop\SmartMolesProject\smart-moles-unit-of-work\src\units\users\contract\contractType\contractType.service.ts", "TypeScript", 52, 4, 8, 64
"c:\Users\Emir TARTAR\Desktop\SmartMolesProject\smart-moles-unit-of-work\src\units\users\contract\subscription\subscription.controller.ts", "TypeScript", 51, 0, 8, 59
"c:\Users\Emir TARTAR\Desktop\SmartMolesProject\smart-moles-unit-of-work\src\units\users\contract\subscription\subscription.dto.ts", "TypeScript", 153, 0, 12, 165
"c:\Users\Emir TARTAR\Desktop\SmartMolesProject\smart-moles-unit-of-work\src\units\users\contract\subscription\subscription.module.ts", "TypeScript", 12, 0, 4, 16
"c:\Users\Emir TARTAR\Desktop\SmartMolesProject\smart-moles-unit-of-work\src\units\users\contract\subscription\subscription.service.ts", "TypeScript", 62, 4, 12, 78
"c:\Users\Emir TARTAR\Desktop\SmartMolesProject\smart-moles-unit-of-work\src\units\users\contract\userContract\userContract.controller.ts", "TypeScript", 51, 0, 9, 60
"c:\Users\Emir TARTAR\Desktop\SmartMolesProject\smart-moles-unit-of-work\src\units\users\contract\userContract\userContract.dto.ts", "TypeScript", 67, 0, 13, 80
"c:\Users\Emir TARTAR\Desktop\SmartMolesProject\smart-moles-unit-of-work\src\units\users\contract\userContract\userContract.module.ts", "TypeScript", 12, 0, 5, 17
"c:\Users\Emir TARTAR\Desktop\SmartMolesProject\smart-moles-unit-of-work\src\units\users\contract\userContract\userContract.service.ts", "TypeScript", 62, 4, 12, 78
"c:\Users\Emir TARTAR\Desktop\SmartMolesProject\smart-moles-unit-of-work\src\units\users\userClaims\permissions\permissions.controller.ts", "TypeScript", 47, 0, 7, 54
"c:\Users\Emir TARTAR\Desktop\SmartMolesProject\smart-moles-unit-of-work\src\units\users\userClaims\permissions\permissions.dto.ts", "TypeScript", 68, 0, 12, 80
"c:\Users\Emir TARTAR\Desktop\SmartMolesProject\smart-moles-unit-of-work\src\units\users\userClaims\permissions\permissions.module.ts", "TypeScript", 12, 0, 3, 15
"c:\Users\Emir TARTAR\Desktop\SmartMolesProject\smart-moles-unit-of-work\src\units\users\userClaims\permissions\permissions.service.ts", "TypeScript", 57, 4, 10, 71
"c:\Users\Emir TARTAR\Desktop\SmartMolesProject\smart-moles-unit-of-work\src\units\users\userClaims\roles\roles.controller.ts", "TypeScript", 43, 0, 8, 51
"c:\Users\Emir TARTAR\Desktop\SmartMolesProject\smart-moles-unit-of-work\src\units\users\userClaims\roles\roles.dto.ts", "TypeScript", 55, 0, 14, 69
"c:\Users\Emir TARTAR\Desktop\SmartMolesProject\smart-moles-unit-of-work\src\units\users\userClaims\roles\roles.module.ts", "TypeScript", 12, 0, 3, 15
"c:\Users\Emir TARTAR\Desktop\SmartMolesProject\smart-moles-unit-of-work\src\units\users\userClaims\roles\roles.service.ts", "TypeScript", 52, 4, 10, 66
"Total", "-", 914, 19, 152, 1085