"filename", "language", "TypeScript", "comment", "blank", "total"
"d:\Yeni-Sistemler\smart-moles-unit-of-work\src\app.module.ts", "TypeScript", 4, 0, 0, 4
"d:\Yeni-Sistemler\smart-moles-unit-of-work\src\units\gateway\gatewayLogs\gatewayLogs.controller.ts", "TypeScript", 55, 0, 9, 64
"d:\Yeni-Sistemler\smart-moles-unit-of-work\src\units\gateway\gatewayLogs\gatewayLogs.dto.ts", "TypeScript", 77, 0, 10, 87
"d:\Yeni-Sistemler\smart-moles-unit-of-work\src\units\gateway\gatewayLogs\gatewayLogs.module.ts", "TypeScript", 12, 0, 4, 16
"d:\Yeni-Sistemler\smart-moles-unit-of-work\src\units\gateway\gatewayLogs\gatewayLogs.service.ts", "TypeScript", 64, 4, 11, 79
"d:\Yeni-Sistemler\smart-moles-unit-of-work\src\units\gateway\gatewayMoistureConditions\gatewayMoistureConditions.controller.ts", "TypeScript", 55, 0, 8, 63
"d:\Yeni-Sistemler\smart-moles-unit-of-work\src\units\gateway\gatewayMoistureConditions\gatewayMoistureConditions.dto.ts", "TypeScript", 84, 0, 10, 94
"d:\Yeni-Sistemler\smart-moles-unit-of-work\src\units\gateway\gatewayMoistureConditions\gatewayMoistureConditions.module.ts", "TypeScript", 12, 0, 4, 16
"d:\Yeni-Sistemler\smart-moles-unit-of-work\src\units\gateway\gatewayMoistureConditions\gatewayMoistureConditions.service.ts", "TypeScript", 63, 4, 10, 77
"Total", "-", 426, 8, 66, 500