"filename", "language", "TypeScript", "comment", "blank", "total"
"d:\Yeni-Sistemler\smart-moles-unit-of-work\1659423318053-src.ts", "TypeScript", 10, 0, 5, 15
"d:\Yeni-Sistemler\smart-moles-unit-of-work\1659425648525-src.ts", "TypeScript", 10, 0, 5, 15
"d:\Yeni-Sistemler\smart-moles-unit-of-work\src\1658908557480-migration.ts", "TypeScript", -128, 0, -5, -133
"d:\Yeni-Sistemler\smart-moles-unit-of-work\src\1659010124840-migrations.ts", "TypeScript", -112, 0, -5, -117
"d:\Yeni-Sistemler\smart-moles-unit-of-work\src\1659010227870-migrations.ts", "TypeScript", -112, 0, -5, -117
"d:\Yeni-Sistemler\smart-moles-unit-of-work\src\1659010971674-migrations.ts", "TypeScript", -112, 0, -5, -117
"d:\Yeni-Sistemler\smart-moles-unit-of-work\src\app.controller.ts", "TypeScript", 6, 1, 1, 8
"d:\Yeni-Sistemler\smart-moles-unit-of-work\src\app.module.ts", "TypeScript", 16, 5, 5, 26
"d:\Yeni-Sistemler\smart-moles-unit-of-work\src\main.ts", "TypeScript", 2, 0, 1, 3
"d:\Yeni-Sistemler\smart-moles-unit-of-work\src\model\WorkGroup\ValveCards\pumpCards.entity.ts", "TypeScript", 0, 0, 1, 1
"d:\Yeni-Sistemler\smart-moles-unit-of-work\src\units\workGroup\sensors\sensorMoistureLogs\sensorMoistureLog.controller.ts", "TypeScript", 55, 0, 8, 63
"d:\Yeni-Sistemler\smart-moles-unit-of-work\src\units\workGroup\sensors\sensorMoistureLogs\sensorMoistureLog.dto.ts", "TypeScript", 67, 0, 11, 78
"d:\Yeni-Sistemler\smart-moles-unit-of-work\src\units\workGroup\sensors\sensorMoistureLogs\sensorMoistureLog.module.ts", "TypeScript", 12, 0, 3, 15
"d:\Yeni-Sistemler\smart-moles-unit-of-work\src\units\workGroup\sensors\sensorMoistureLogs\sensorMoistureLog.service.ts", "TypeScript", 63, 4, 14, 81
"d:\Yeni-Sistemler\smart-moles-unit-of-work\src\units\workGroup\timerManagement\timerManagementDetail\timerManagementDetail.controller.ts", "TypeScript", 61, 0, 11, 72
"d:\Yeni-Sistemler\smart-moles-unit-of-work\src\units\workGroup\timerManagement\timerManagementDetail\timerManagementDetail.dto.ts", "TypeScript", 97, 0, 18, 115
"d:\Yeni-Sistemler\smart-moles-unit-of-work\src\units\workGroup\timerManagement\timerManagementDetail\timerManagementDetail.module.ts", "TypeScript", 14, 0, 3, 17
"d:\Yeni-Sistemler\smart-moles-unit-of-work\src\units\workGroup\timerManagement\timerManagementDetail\timerManagementDetail.service.ts", "TypeScript", 70, 4, 12, 86
"d:\Yeni-Sistemler\smart-moles-unit-of-work\src\units\workGroup\timerManagement\timerManagementLogs\timerManagementLogs.controller.ts", "TypeScript", 55, 0, 10, 65
"d:\Yeni-Sistemler\smart-moles-unit-of-work\src\units\workGroup\timerManagement\timerManagementLogs\timerManagementLogs.dto.ts", "TypeScript", 72, 0, 9, 81
"d:\Yeni-Sistemler\smart-moles-unit-of-work\src\units\workGroup\timerManagement\timerManagementLogs\timerManagementLogs.module.ts", "TypeScript", 12, 0, 5, 17
"d:\Yeni-Sistemler\smart-moles-unit-of-work\src\units\workGroup\timerManagement\timerManagementLogs\timerManagementLogs.service.ts", "TypeScript", 63, 4, 13, 80
"d:\Yeni-Sistemler\smart-moles-unit-of-work\src\units\workGroup\timerManagement\timerManagement\timerManagement.controller.ts", "TypeScript", 55, 0, 11, 66
"d:\Yeni-Sistemler\smart-moles-unit-of-work\src\units\workGroup\timerManagement\timerManagement\timerManagement.dto.ts", "TypeScript", 60, 0, 13, 73
"d:\Yeni-Sistemler\smart-moles-unit-of-work\src\units\workGroup\timerManagement\timerManagement\timerManagement.module.ts", "TypeScript", 12, 0, 4, 16
"d:\Yeni-Sistemler\smart-moles-unit-of-work\src\units\workGroup\timerManagement\timerManagement\timerManagement.service.ts", "TypeScript", 63, 4, 13, 80
"d:\Yeni-Sistemler\smart-moles-unit-of-work\src\units\workGroup\valveCards\pumpCardLogs\pumpCardLogs.controller.ts", "TypeScript", 55, 0, 11, 66
"d:\Yeni-Sistemler\smart-moles-unit-of-work\src\units\workGroup\valveCards\pumpCardLogs\pumpCardLogs.dto.ts", "TypeScript", 72, 0, 9, 81
"d:\Yeni-Sistemler\smart-moles-unit-of-work\src\units\workGroup\valveCards\pumpCardLogs\pumpCardLogs.module.ts", "TypeScript", 12, 0, 5, 17
"d:\Yeni-Sistemler\smart-moles-unit-of-work\src\units\workGroup\valveCards\pumpCardLogs\pumpCardLogs.service.ts", "TypeScript", 63, 4, 13, 80
"d:\Yeni-Sistemler\smart-moles-unit-of-work\src\units\workGroup\valveCards\pumpCards\pumpCards.controller.ts", "TypeScript", 73, 0, 16, 89
"d:\Yeni-Sistemler\smart-moles-unit-of-work\src\units\workGroup\valveCards\pumpCards\pumpCards.dto.ts", "TypeScript", 127, 0, 8, 135
"d:\Yeni-Sistemler\smart-moles-unit-of-work\src\units\workGroup\valveCards\pumpCards\pumpCards.module.ts", "TypeScript", 12, 0, 2, 14
"d:\Yeni-Sistemler\smart-moles-unit-of-work\src\units\workGroup\valveCards\pumpCards\pumpCards.service.ts", "TypeScript", 70, 4, 13, 87
"d:\Yeni-Sistemler\smart-moles-unit-of-work\src\units\workGroup\valveCards\valveCardLogs\valveCardLogs.controller.ts", "TypeScript", 47, 0, 8, 55
"d:\Yeni-Sistemler\smart-moles-unit-of-work\src\units\workGroup\valveCards\valveCardLogs\valveCardLogs.dto.ts", "TypeScript", 72, 0, 9, 81
"d:\Yeni-Sistemler\smart-moles-unit-of-work\src\units\workGroup\valveCards\valveCardLogs\valveCardLogs.module.ts", "TypeScript", 12, 0, 3, 15
"d:\Yeni-Sistemler\smart-moles-unit-of-work\src\units\workGroup\valveCards\valveCardLogs\valveCardLogs.service.ts", "TypeScript", 63, 4, 12, 79
"d:\Yeni-Sistemler\smart-moles-unit-of-work\src\units\workGroup\valveCards\valveCards\valveCards.controller.ts", "TypeScript", 67, 0, 17, 84
"d:\Yeni-Sistemler\smart-moles-unit-of-work\src\units\workGroup\valveCards\valveCards\valveCards.dto.ts", "TypeScript", 188, 0, 7, 195
"d:\Yeni-Sistemler\smart-moles-unit-of-work\src\units\workGroup\valveCards\valveCards\valveCards.module.ts", "TypeScript", 12, 0, 2, 14
"d:\Yeni-Sistemler\smart-moles-unit-of-work\src\units\workGroup\valveCards\valveCards\valveCards.service.ts", "TypeScript", 77, 4, 17, 98
"Total", "-", 1433, 38, 308, 1779